-10
17
-5
14
1111111111111111111111111111
0000000000001110000000000001
0000000000001110000000000001
0000000100001110000100000001
0000000100000000000100000001
0000000100000000000100000001
0000000100001110000100000001
0000000100001110000100000001
0000000000001110000000000001
0000090000001110000009000001
2000090000001110000009000021
0000090000001110000009000001
0000000000001110000000000001
0000000100001110000100000001
0000000100001110000100000001
0000000100000000000100000001
0000000100000000000100000001
0000000100001110000100000001
0000000000001110000000000001
0000000000001110000000000001
